0000000000000000000000000000000000000000000000000000000
0000000000000000000000000000000000000000000000000000000
0000000000000000000000000000000000000000000000000000000
0000000000000000000000000000000000000000000000000000000
0000000000000000000000000000000000000000000000000000000
0000000000000000000000000000000000000000000000000000000
1111111111111111111100000000000000000000000000000000000
0000000000000000000000000000000000000000000000000000000
1111111111111111111111111111111111111111111111111111111
2222222000000000000000000000000000000000000000000000000
2222222200000000000000000000000000000000000000000000000
2222222000000000000000000000000000000000000000000000000
2222220000000000000000000000000000000000000000000000000
2222222222200000000000000000000000000000000000000000000
2222222222200000000000000000000000000000000000000000000
0000000000000000000000000000000000000000000000000000000
0000000000000000000000000000000000000000000000000000000
0000000000000000000000000000000000000000000000000000000
0000000000000000000000000000000000000000000000000000000
0000000000000000000000000000000000000000000000000000000